0000000000000000000000000000000000000000000000000000000000000000
0000000000000000001111100000000000000000000000000000000000000000
0000000000000000000001000000000000000000000000000000000000000000
0000000000000000000010000000000000000000000000000000000000000001
0000000000000000000100000000000000000000000000000000000000000001
0000000000000000001000000000000000000000000000000000000000000011
0000000000000000000000000000000000000000000000000000000000000011
0000000000000000000000000000000000000000000000000000000000001111
0000000000000000000000000000000000000000000000000000000000001111
0000000000000000000000000000000000000000000000000000000000111111
0000000000000000000000000000000000000000000000000000000000111111
0000000000000000000000000000000000000000000000000000000011111111
0000000000000000000000000000000000000000000000000000000011111111
0000000000000000000000000000000000000000000000000000000011111111
1111111111111111111111111111111111111111111111111111111111111111